222222222222222222222222222222222222222222222222222222222222222222222222222222222222222222222222222222222222222222222222222222222222222222222222222222
222222222222222222222222222222222222222222222222222222222222222222222222222222222222222222222222222222222222222222222222222222222222222222222222222222
222111221122222222222222222222222222222222222222222222222222222222222222222222222222222222222222222222222222222222222222222222222222222222222222222222
2211111111122222222222222222222222222222222222222222222222222222222222222222222222222222222222222222222222222222222222222222Z3222222222222222222222222
22117111133122222222222222222222000000000000000000000000000000000000000000000000000000000000000FC22FC22FC22FC22222222222222222322222222222222222222222
222111333332122222222222222222202222222222220000000000000010000222222222222222222222222222222FD22ED22ED22ED22EC222222222222222322222222222222222222222
2221113333222122222222222222222022222222200000010000000100000002222222222222222222222222222FD222222222222222222EC2222222222233333222222222222222222222
22111333332222122222222222222220222222222022000000000000001000022222222222222222222222222FD2222222222222222222222EC22222333333333332222222222222222222
222118222222222122244444422222202222222222220100000100000110000222222222222222222222222FD22222222222222222222222222EC233333333333333332222222222222222
222222A222222221144444444422222022222222222200000000000000000002222222222222222222222FD222222222222222222222222222222333333333333333333222222222222222
222222G2222221114444444444444220222222222222000000000000100000022222222222222222222FD22222222222222222222222222222222333333333333333333322222222222222
22222B2222222144444444441444444022222222222222222222222222222222222222222222222333332222222222222222222222222222222FD223333333333333333322222222222222
22222H22222221444444444444444445422222222222222222222222222222222222222222222233333333222222222222222222222222222FD22222233333333333333222222222222222
222222A2221111224444444444444445422222222222222222222222222222222222222222222Y333333333322222222222222222222222FD2222222222333333332222222222222222222
222222G2221112222244444444444000022222222222222222222222222222222222222222222233333333322222222222222222222222B22222222222222222222A222222222222222222
22222B22221112222224444444444022222222222222222222222222222222222222222222222222233333222222222222222222222222G22222222222222222222G222222222222222222
22222G22222122222224444444400222222222222222222222222222222222222222222222222222222222A222222222222222222222FD22222222222222222222B2222222222222222222
2222B222222122222244444444022222222222223332222222222222222222222222222222222222222222H22222222222222222222B2222222222222222222222G2222222222222222222
2222G2222221111111166666002222222222222322223222222222222222222222222222222222222222222A2222222222222222222G222222222222222222222B22222222222222222222
222B22222221222222224440222222222222222333333322222222222222222222222222222222222222222H22222222222222222FD2222222222222222222222G22222222222222222222
222H222222222222222244022222222222222233333333222222222222222222222222222222222222222222A222222222222222B22222222222222222222222B222222222222222222222
2222EC2222222222222222222222222222222333333333222222222222222222222222222222222222222222H222222222222222G22222222222222222222222G222222222222222222222
222222A22222222222222222222222FC222223333333322222222222222222222222222222222222222222222A2222222222222B22222222222222222222222B2222222222222222222222
222222G22222222222222222FC22FD22EC22233333322A2222222222222222222222222222222222222222222H2222222222222G22222222222222222222222G2222222222222222222222
222223332222222222FC22FD22ED222222A2222333222H22222222222222222222222222222222222222222222A22222222222B22222222222222222222222B22222222222222222222222
22223333332222222B22ED222222222222H22FD3322222EC222222222222222222222222222222222222222222H22222222222G22222222222222222222222G22222222222222222222222
22233333333222222G22222222222222222ED22222222222EC22222222222222222222222222222222222222222A222222222B22222222222222222222222B222222222222222222222222
222333333333322FD222222222222222222222222222222222EC222222222222222222222222222222222222222G222222222G22222222222222222222222G222222222222222222222222
22223333333333D2222222222222222222222222222222222222EC222222222222222222222222222222222222B222222222B22222222222222222222222B2222222222222222222222222
222222333333322222222222222222222222222222222222222222EC2222222222222222222222222222222222H222222222G22222222222222222222222H2222222222222222222222222
22223313333222222222222222222222222222222222222222222222EC2222222222222222222222222222222223333333332222222222222222222222222EC22222222222222222222222
2222211133322222222222222222222222222222222222222222222222EC2222222222222222222222222222233333333333332222222222222222222222222EC222222222222222222222
222222133322222222222222222222222222222222222222222222222222A22222222222222222222222222223333333333333322222222222222222222222222A22222222222222222222
2222222222A2222222222222222222222222222222222222222222222222H22222222222222222222222222222233333333322A22222222222222222222222222G22222222222222222222
2222222222H22222222222222222222222222222222222222222222222222EC222222222222222222222222222222222222222H2222222222222222222222222B222222222222222222222
22222222222A222222222222222222222222222222222222222222222222222A222222222222222222222222222222222222222A222222222222222222222222H222222222222222222222
22222222222H222222222222222222222222222222222222222222222222222H222222222222222222222222222222222222222H2222222222222222222222222A22222222222222222222
222222222222A222222222222222222222222222222222222222222222222222EC22222222222222222222222222222222222222EC22222222222222222222222G22222222222222222222
222222222222G22222222222222222222222222222222222222222222222222222EC22222222222222222222222222222222222222EC22222222222222222222B222222222222222222222
22222222222B22222222222222222222222222222222222222222222222222222222EC22222222222222222222222222222222222222EC222222222222222222G222222222222222222222
22222222222H2222222222222222222222222222222222222222222222222222222222EC22222222222222222222222222222222222222EC222222222222222B2222222222222222222222
222222222222EC2222222222222222222222222222222222222222222222222222222222A222222222222222222222222222222222222222EC2222222222222G2222222222222222222222
22222222222222A222222222222222222222222222222222222222222222222222222222H22222222222222222222222222222222222222222EC2222222222B22222222222222222222222
22222222222222G2222222222222222222222222222222222222222222222222222222222A222222222222222222222222222222222222222222EC22222222G22222222222222222222222
2222222222222B22222222222222222222222222222222222222222222222222222222222H22222222222222222222222222222222222222222222EC22222B222222222222222222222222
2222222222222H222222222222222222222222222222222222222222222222222222222222A222222222222222222222222222222222222222222222EC222G222222222222222222222222
22222222222222A22222222222222222222222222222222222222222222222222222222222H22222222222222222222222222222222222222222222222A2B2222222222222222222444444
22222222222222G222222222222222222222222222222222222222222222222222222222222A2222222222222222222222222222222222222222222222H2G2222222222444444444444444
222222222222FD2222222222222222222222222222222222222222222222222222222222222H22222222222222222222222222222222222222222222222544444444444444444444444444
22222222222B2222222222222222222222222222222222222222222222222222222222222222A2222222222222222222222222222222224444444444444544444444444444444444222222
22222222222H2222222222222222222222222222222222222222222222222222222222222222H2222222222222224444444444444444444444444444444544444444222222222222222222
222222222222A22222222222222222222222222222222222222200000000000000222244444445444444444444444444444444444444444444444444442H22222222222222222222222222
222222222222H222222222222220000000000000000000000000444444444444444444444444454444444444444444444444444444444222222222222222A2222222222222222222222222
0000000000000000000000000004444444444444444444444544444444444444444444444444454444444444444444444444422222222222222222222222H2222222222222222222222222
44444444444444444444444444444444444444444444444445444444444444444000022222222H22222444444444444444444444422222222222222222222A222222222222222222222222
444444444444444444444444444444444444444444444444454000000000000002222222222222A22222222222222224444444444444442222222222222333332222222222222222222222
444444444444444444444444400000000000000000000000000002222222222222222222222222G22222222222222222224444444444444422222222223331333222222222222222222222
00000000000000000000000000002222222222222222222222222A2222222222222222222222FD222222222222222222222222244444444444422222223333333322222222222222222222
22222222222222222222222222222222222222222222222222222G222222222222222222222B22222222222222222222222222222222444444444222222333332222222222222222222222
2222222222222222222222222222222222222222222222222222B2222222222222222222222H222222222222222222222222222222222224444444422222B2222222222222222222222222
2222222222222222222222222222222222222222222222222222G22222222222222222222222A22222222222222222222222222222222222222444444222G2222222222222222222222222
222222222222222222222222222222222222222222222222222B222222222222222222222222H2222222222222222222222222222222222222222224444B22222222222222222222222222
222222222222222222222222222222222222222222222222222H2222222222222222222222222822222222222222222222222222222222FC22222222244544422222222222222222222222
2222222222222222222222222222222222222222222222222222A2222222222222222222233333332222222222222222222222222222FD22EC222222222544444222222222222222222222
2222222222222222222222222222222222222222222222222222G22222222222223333333333333333333222222222222222222222FD222222EC2222222G24444442222222222222222222
222222222222222222222222222222222222222222222222222B2222222222233333333333333333333333333333332222222222FD2222222222EC2222B222244444222222222222222222
222222222222222222222222222222222222222222222222222H22222222223333333333333333333333333333333333222222FD22222222222222EC22G222222444444222222222222222
2222222222222222222222222222222222222222222222222222EC2222222333333333333333333333333333333333333322FD222222222222222222ED2222222224444442222222222222
222222222222222222222222222222222222222222222222222222EC22FC223333333333333333333333333333333333333322222222222222222222222222222222224444444222222222
22222222222222222222222222222222222222222222222222222222ED22E83333333333333333333333333333333333333322222222222222222222222222222222222224444442222222
222222222222222222222222222222222222222222222222222222222222233333333333333333333333333333333333333332222222222222222222222222222222222222224444442222
222222222222222222222222222222222222222222222222222222222222222333333333333333333333333333333333333322222222222222222222222222222222222222222224444442
222222222222222222222222222222222222222222222222222222222222222222333333333333333333333333333333333222222222222222222222222222222222222222222222224444
222222222222222222222222222222222222222222222222222222222222222222233333333333333333333333333333332222222222222222222222222222222222222222222222222244
222222222222222222222222222222222222222222222222222222222222222222222333333333333333333333333322222222222222222222222222222222222222222222222222222222
222222222222222222222222222222222222222222222222222222222222222222222222333333333333333333322222222222222222222222222222222222222222222222222222222222
222222222222222222222222222222222222222222222222222222222222222222222222222222222222222222222222222222222222222222222222222222222222222222222222222222
222222222222222222222222222222222222222222222222222222222222222222222222222222222222222222222222222222222222222222222222222222222222222222222222222222
222222222222222222222222222222222222222222222222222222222222222222222222222222222222222222222222222222222222222222222222222222222222222222222222222222
222222222222222222222222222222222222222222222222222222222222222222222222222222222222222222222222222222222222222222222222222222222222222222222222222222
222222222222222222222222222222222222222222222222222222222222222222222222222222222222222222222222222222222222222222222222222222222222222222222222222222
222222222222222222222222222222222222222222222222222222222222222222222222222222222222222222222222222222222222222222222222222222222222222222222222222222
222222222222222222222222222222222222222222222222222222222222222222222222222222222222222222222222222222222222222222222222222222222222222222222222222222
222222222222222222222222222222222222222222222222222222222222222222222222222222222222222222222222222222222222222222222222222222222222222222222222222222
222222222222222222222222222222222222222222222222222222222222222222222222222222222222222222222222222222222222222222222222222222222222222222222222222222
222222222222222222222222222222222222222222222222222222222222222222222222222222222222222222222222222222222222222222222222222222222222222222222222222222
222222222222222222222222222222222222222222222222222222222222222222222222222222222222222222222222222222222222222222222222222222222222222222222222222222
222222222222222222222222222222222222222222222222222222222222222222222222222222222222222222222222222222222222222222222222222222222222222222222222222222
222222222222222222222222222222222222222222222222222222222222222222222222222222222222222222222222222222222222222222222222222222222222222222222222222222
222222222222222222222222222222222222222222222222222222222222222222222222222222222222222222222222222222222222222222222222222222222222222222222222222222
222222222222222222222222222222222222222222222222222222222222222222222222222222222222222222222222222222222222222222222222222222222222222222222222222222
222222222222222222222222222222222222222222222222222222222222222222222222222222222222222222222222222222222222222222222222222222222222222222222222222222
222222222222222222222222222222222222222222222222222222222222222222222222222222222222222222222222222222222222222222222222222222222222222222222222222222
222222222222222222222222222222222222222222222222222222222222222222222222222222222222222222222222222222222222222222222222222222222222222222222222222222
222222222222222222222222222222222222222222222222222222222222222222222222222222222222222222222222222222222222222222222222222222222222222222222222222222
222222222222222222222222222222222222222222222222222222222222222222222222222222222222222222222222222222222222222222222222222222222222222222222222222222
222222222222222222222222222222222222222222222222222222222222222222222222222222222222222222222222222222222222222222222222222222222222222222222222222222
222222222222222222222222222222222222222222222222222222222222222222222222222222222222222222222222222222222222222222222222222222222222222222222222222222
222222222222222222222222222222222222222222222222222222222222222222222222222222222222222222222222222222222222222222222222222222222222222222222222222222
222222222222222222222222222222222222222222222222222222222222222222222222222222222222222222222222222222222222222222222222222222222222222222222222222222
222222222222222222222222222222222222222222222222222222222222222222222222222222222222222222222222222222222222222222222222222222222222222222222222222222
222222222222222222222222222222222222222222222222222222222222222222222222222222222222222222222222222222222222222222222222222222222222222222222222222222
222222222222222222222222222222222222222222222222222222222222222222222222222222222222222222222222222222222222222222222222222222222222222222222222222222
222222222222222222222222222222222222222222222222222222222222222222222222222222222222222222222222222222222222222222222222222222222222222222222222222222
222222222222222222222222222222222222222222222222222222222222222222222222222222222222222222222222222222222222222222222222222222222222222222222222222222
222222222222222222222222222222222222222222222222222222222222222222222222222222222222222222222222222222222222222222222222222222222222222222222222222222
222222222222222222222222222222222222222222222222222222222222222222222222222222222222222222222222222222222222222222222222222222222222222222222222222222
222222222222222222222222222222222222222222222222222222222222222222222222222222222222222222222222222222222222222222222222222222222222222222222222222222
222222222222222222222222222222222222222222222222222222222222222222222222222222222222222222222222222222222222222222222222222222222222222222222222222222
222222222222222222222222222222222222222222222222222222222222222222222222222222222222222222222222222222222222222222222222222222222222222222222222222222
222222222222222222222222222222222222222222222222222222222222222222222222222222222222222222222222222222222222222222222222222222222222222222222222222222
222222222222222222222222222222222222222222222222222222222222222222222222222222222222222222222222222222222222222222222222222222222222222222222222222222
222222222222222222222222222222222222222222222222222222222222222222222222222222222222222222222222222222222222222222222222222222222222222222222222222222
222222222222222222222222222222222222222222222222222222222222222222222222222222222222222222222222222222222222222222222222222222222222222222222222222222
222222222222222222222222222222222222222222222222222222222222222222222222222222222222222222222222222222222222222222222222222222222222222222222222222222
222222222222222222222222222222222222222222222222222222222222222222222222222222222222222222222222222222222222222222222222222222222222222222222222222222
222222222222222222222222222222222222222222222222222222222222222222222222222222222222222222222222222222222222222222222222222222222222222222222222222222
222222222222222222222222222222222222222222222222222222222222222222222222222222222222222222222222222222222222222222222222222222222222222222222222222222
222222222222222222222222222222222222222222222222222222222222222222222222222222222222222222222222222222222222222222222222222222222222222222222222222222
222222222222222222222222222222222222222222222222222222222222222222222222222222222222222222222222222222222222222222222222222222222222222222222222222222
222222222222222222222222222222222222222222222222222222222222222222222222222222222222222222222222222222222222222222222222222222222222222222222222222222
222222222222222222222222222222222222222222222222222222222222222222222222222222222222222222222222222222222222222222222222222222222222222222222222222222
222222222222222222222222222222222222222222222222222222222222222222222222222222222222222222222222222222222222222222222222222222222222222222222222222222
222222222222222222222222222222222222222222222222222222222222222222222222222222222222222222222222222222222222222222222222222222222222222222222222222222
222222222222222222222222222222222222222222222222222222222222222222222222222222222222222222222222222222222222222222222222222222222222222222222222222222
222222222222222222222222222222222222222222222222222222222222222222222222222222222222222222222222222222222222222222222222222222222222222222222222222222
222222222222222222222222222222222222222222222222222222222222222222222222222222222222222222222222222222222222222222222222222222222222222222222222222222
222222222222222222222222222222222222222222222222222222222222222222222222222222222222222222222222222222222222222222222222222222222222222222222222222222
222222222222222222222222222222222222222222222222222222222222222222222222222222222222222222222222222222222222222222222222222222222222222222222222222222
222222222222222222222222222222222222222222222222222222222222222222222222222222222222222222222222222222222222222222222222222222222222222222222222222222
222222222222222222222222222222222222222222222222222222222222222222222222222222222222222222222222222222222222222222222222222222222222222222222222222222
222222222222222222222222222222222222222222222222222222222222222222222222222222222222222222222222222222222222222222222222222222222222222222222222222222
222222222222222222222222222222222222222222222222222222222222222222222222222222222222222222222222222222222222222222222222222222222222222222222222222222
222222222222222222222222222222222222222222222222222222222222222222222222222222222222222222222222222222222222222222222222222222222222222222222222222222
222222222222222222222222222222222222222222222222222222222222222222222222222222222222222222222222222222222222222222222222222222222222222222222222222222
222222222222222222222222222222222222222222222222222222222222222222222222222222222222222222222222222222222222222222222222222222222222222222222222222222
222222222222222222222222222222222222222222222222222222222222222222222222222222222222222222222222222222222222222222222222222222222222222222222222222222
222222222222222222222222222222222222222222222222222222222222222222222222222222222222222222222222222222222222222222222222222222222222222222222222222222
222222222222222222222222222222222222222222222222222222222222222222222222222222222222222222222222222222222222222222222222222222222222222222222222222222
222222222222222222222222222222222222222222222222222222222222222222222222222222222222222222222222222222222222222222222222222222222222222222222222222222
222222222222222222222222222222222222222222222222222222222222222222222222222222222222222222222222222222222222222222222222222222222222222222222222222222
222222222222222222222222222222222222222222222222222222222222222222222222222222222222222222222222222222222222222222222222222222222222222222222222222222
222222222222222222222222222222222222222222222222222222222222222222222222222222222222222222222222222222222222222222222222222222222222222222222222222222
222222222222222222222222222222222222222222222222222222222222222222222222222222222222222222222222222222222222222222222222222222222222222222222222222222
222222222222222222222222222222222222222222222222222222222222222222222222222222222222222222222222222222222222222222222222222222222222222222222222222222
222222222222222222222222222222222222222222222222222222222222222222222222222222222222222222222222222222222222222222222222222222222222222222222222222222
222222222222222222222222222222222222222222222222222222222222222222222222222222222222222222222222222222222222222222222222222222222222222222222222222222
222222222222222222222222222222222222222222222222222222222222222222222222222222222222222222222222222222222222222222222222222222222222222222222222222222
222222222222222222222222222222222222222222222222222222222222222222222222222222222222222222222222222222222222222222222222222222222222222222222222222222
222222222222222222222222222222222222222222222222222222222222222222222222222222222222222222222222222222222222222222222222222222222222222222222222222222
